5
0	2	2	1	0
2	4	3	3	1
2	1	1	3	4
3	1	3	0	2
1	1	3	3	2